

NO ./wall_tex/wave_of_kaganav1.xpm
C  102,102,153
EA ./wall_tex/wall_pink_tyan1.xpm


WE ./wall_tex/wave_of_kaganav3.xpm


SO ./wall_tex/wave_of_kaganav2.xpm


F  205,136,179


R    1000  1000







S  ./sprt_tex/sprt_enot.xpm
111111111111111111111111       1     111111111111111111111
1111110000000000001           1      10101000000001000001
1000000000000110111111111       1    101010222222000000011
10000000000000000000100011           101010222222010000011
100000000000000000000100011          100010222222000000011
1000000000000000000000100011         10101022222201000001
10000000000000000000000100011        101010222222010000011
10000000000000000000000100011        110101010000000100001
11111111111111111101111111111111111111111111110111111111111111
                 101                         101
11111111111111111101111111111111111111111111110111111111111111
1111111111111100110100000100011111111010101111011111000011
1000000000000000100000001000000000000000000000000000001011
1000000001000000100000001000000000000000000000000000001011
1000001111111110100001110001111111100022222222222222201011
1000000000000000100000001001000000100022222222222222201011
1000010000100000100001001001000000100022222222222222201011
1000000100010000100000001001000000100022222222222222201011
1001000001000000100000001001000000100022222222222222201011
1W00000000000000000000000000000000000000000000000000001011
111111111111111111111111111111111111111111111111111111111