R    1000  1000

NO ./wall_tex/wave_of_kaganav1.xpm

SO ./wall_tex/wave_of_kaganav2.xpm
WE ./wall_tex/wall_pink_tyan2.xpm
EA ./wall_tex/wall_pink_tyan1.xpm
S  ./sprt_tex/sprt_tyan2.xpm

F  205,136,179

C  102,102,153
        1111111111111111111111111
 11     1111111111111111111111111
    1   1000000000110000000000001
  1     1011000001110000002000001 1111
        1001000000000000000000001
111111111011000001110000000000001 111 1 1
100000000011000001110111111111111
11110111111111011100000010001
11110111111111011101010010001

    11111111111110011111111111111111111 1 1 1 1 1 1 1 1111 1 1 1111 1 111 11111111 11 1111 1 1
11000000110101011100000010001 111
10002000000000001100000010001
10000000000000001101010010001
11000001110101011111011110N0111
11110111 1110101 101111010001
11111111 1111111 111111111111 111 1 1 1 1 1 1 1 1 1 1 1 1 1 11111  1 11  1  11  11 1 1 11
