C  255,0,0

NO ./wall_tex/wave_of_kaganav1.xpm
EA ./wall_tex/wave_of_kaganav2.xpm
S ./sprt_tex/sprt_enot.xpm
SO ./wall_tex/wave_of_kaganav2.xpm

WE ./wall_tex/wave_of_kaganav3.xpm
R    800       800

F  102,102,153

        1111111111111111111111111
        1000000000000022222222001
        1011000000000022222222001
        1001000000000022222222001
111111111011000000000000111111111
100000000011000000000100000000001
111101111111110111000000000000001
111101111111110111010000000000001
110000001101010111000000000000001
100020000000000011000000000000001
100000000000000011010100000000001
11000001110101011111011100W011111
11110111 1110101 101111000001
11111111 1111111 111111111111